0000100000
0111111110
0100003010
0123010110
1322221011
0101231010
0131122310
0100000010
0112323310
0000100000