0000100000
0111111110
0111111110
0111111110
1111111111
0111111110
0111111110
0111111110
0111111110
0000100000