0000000000
0433012110
0133031200
0210012100
0202112120
0100312100
0313232020
0103030130
0202121200
0000000000