4213122123
1232311112
1112211123
3333333332
1232233321
1123122123
1232111223
2222212321
2311211212
1111111115