0132004332
1433012113
2133031203
1210012101
1202112122
2000312100
3313232023
3103030131
2202121203
1011002200
