0000100000
0333332120
0000030000
0223022120
1322021031
0101231330
0131022310
0000030020
0332323310
0000200000