0000100000
0222221220
0100000000
0223022120
1322221011
0101231010
0131122310
0000000020
0332323310
0000200000