0000100000
0133212110
0133031200
0210012100
1202112120
0100312120
0313232020
0103030130
0202021210
0000000000