0000000000
0133012110
0133031200
0210012100
1202112121
0100312120
0313232020
0103030130
0202121210
0000100000